geoid,gisjoin,name,five_star,four_star,three_star,two_star,one_star,total,male_18_24
22001,G2200010,Acadia,0,1,2,1,0,4,2951
51001,G5100010,Accomack,0,0,0,1,0,1,1254
16001,G1600010,Ada,0,1,3,17,0,21,18087
08001,G0800010,Adams,0,1,7,5,0,13,21211
17001,G1700010,Adams,0,0,1,1,0,2,2988
28001,G2800010,Adams,0,1,0,2,0,3,1333
31001,G3100010,Adams,0,1,0,0,0,1,1968
45003,G4500030,Aiken,0,3,5,5,0,13,7165
12001,G1200010,Alachua,0,2,12,9,0,23,26978
37001,G3700010,Alamance,1,0,2,2,0,5,7526
06001,G0600010,Alameda,0,20,35,51,0,106,76299
36001,G3600010,Albany,0,0,1,3,0,4,19933
28003,G2800030,Alcorn,0,1,1,0,0,2,1470
37003,G3700030,Alexander,0,1,1,0,0,2,1384
51510,G5105100,Alexandria,0,1,6,3,0,10,4708
26005,G2600050,Allegan,0,0,2,3,0,5,4369
36003,G3600030,Allegany,0,0,1,3,0,4,4205
42003,G4200030,Allegheny,4,27,62,42,1,136,61364
18003,G1800030,Allen,1,3,14,8,0,26,16549
22003,G2200030,Allen,0,0,0,1,0,1,1231
39003,G3900030,Allen,0,1,1,0,0,2,6650
45005,G4500050,Allendale,0,1,2,1,0,4,549
51009,G5100090,Amherst,0,0,3,1,0,4,1419
28005,G2800050,Amite,0,0,2,1,0,3,520
02020,G0200200,Anchorage,0,0,0,3,0,3,17472
45007,G4500070,Anderson,0,4,10,1,0,15,7765
47001,G4700010,Anderson,0,0,0,1,0,1,2930
48001,G4800010,Anderson,1,0,2,3,0,6,2841
48003,G4800030,Andrews,0,1,0,0,0,1,724
48005,G4800050,Angelina,1,8,8,4,0,21,3951
24003,G2400030,Anne Arundel,0,1,2,4,0,7,26823
27003,G2700030,Anoka,0,0,2,2,0,4,13798
37007,G3700070,Anson,1,1,3,0,0,5,1348
13001,G1300010,Appling,0,0,1,0,0,1,818
08005,G0800050,Arapahoe,3,8,13,17,0,41,24697
26011,G2600110,Arenac,0,0,0,1,0,1,568
05001,G0500010,Arkansas,0,0,1,0,0,1,729
51013,G5100130,Arlington,0,0,2,2,0,4,9651
42005,G4200050,Armstrong,0,0,0,1,0,1,2521
22005,G2200050,Ascension,0,1,0,1,0,2,4635
05003,G0500030,Ashley,0,0,0,1,0,1,840
39007,G3900070,Ashtabula,0,0,0,3,0,3,4150
22007,G2200070,Assumption,0,0,1,0,0,1,1073
34001,G3400010,Atlantic,0,4,7,1,0,12,12816
28007,G2800070,Attala,0,1,3,0,0,4,752
29007,G2900070,Audrain,0,1,0,0,0,1,922
51015,G5100150,Augusta,0,0,1,0,0,1,2997
48015,G4800150,Austin,0,1,0,6,0,7,1064
01001,G0100010,Autauga,1,5,13,3,0,22,2335
22009,G2200090,Avoyelles,0,0,1,2,0,3,1914
48017,G4800170,Bailey,0,0,1,0,0,1,332
12003,G1200030,Baker,0,0,2,1,0,3,1330
01003,G0100030,Baldwin,3,5,11,12,0,31,7019
13009,G1300090,Baldwin,1,4,16,5,0,26,3879
24005,G2400050,Baltimore,1,4,5,4,0,14,40042
24510,G2405100,Baltimore,1,10,18,14,0,43,36840
45009,G4500090,Bamberg,2,1,5,0,0,8,1130
16005,G1600050,Bannock,0,0,1,0,0,1,5032
01005,G0100050,Barbour,0,1,1,3,0,5,1408
45011,G4500110,Barnwell,0,0,1,0,0,1,986
21009,G2100090,Barren,0,0,0,0,1,1,1687
55005,G5500050,Barron,0,0,0,1,0,1,1819
13013,G1300130,Barrow,0,0,1,0,0,1,2895
18005,G1800050,Bartholomew,1,1,5,0,0,7,3119
20009,G2000090,Barton,0,0,1,0,0,1,1285
13015,G1300150,Bartow,1,2,7,3,0,13,4368
48021,G4800210,Bastrop,0,1,1,2,0,4,3132
05005,G0500050,Baxter,0,0,0,1,0,1,1202
12005,G1200050,Bay,1,3,2,6,0,12,8252
26017,G2600170,Bay,0,1,0,0,0,1,4701
45013,G4500130,Beaufort,0,3,2,1,0,6,9624
22011,G2200110,Beauregard,0,1,1,0,0,2,1673
42007,G4200070,Beaver,1,4,9,8,0,22,6806
42009,G4200090,Bedford,0,0,2,0,0,2,1810
51019,G5100190,Bedford,0,0,1,0,0,1,2374
51515,G5105150,Bedford,0,0,2,2,0,4,298
33001,G3300010,Belknap,0,0,1,2,0,3,2078
21013,G2100130,Bell,0,0,2,1,0,3,1307
48027,G4800270,Bell,1,5,16,4,0,26,20376
39013,G3900130,Belmont,0,0,1,0,0,1,3398
13017,G1300170,Ben Hill,0,0,1,2,0,3,743
05007,G0500070,Benton,0,1,6,4,0,11,9147
27009,G2700090,Benton,0,0,0,1,0,1,2022
41003,G4100030,Benton,0,1,0,1,0,2,10451
53005,G5300050,Benton,0,0,4,4,0,8,8002
34003,G3400030,Bergen,1,11,33,16,0,61,34555
45015,G4500150,Berkeley,0,7,10,2,0,19,10531
54003,G5400030,Berkeley,0,1,1,1,0,3,3951
42011,G4200110,Berks,2,2,4,6,0,14,20584
35001,G3500010,Bernalillo,0,2,3,9,0,14,34700
13019,G1300190,Berrien,0,0,1,0,0,1,822
37015,G3700150,Bertie,0,1,1,0,0,2,1024
48029,G4800290,Bexar,0,11,36,25,1,73,97724
01007,G0100070,Bibb,0,0,2,0,0,2,1104
13021,G1300210,Bibb,0,1,7,1,0,9,7612
22013,G2200130,Bienville,0,0,0,1,0,1,647
16011,G1600110,Bingham,0,0,0,1,0,1,1979
19013,G1900130,Black Hawk,0,0,5,0,0,5,9664
42013,G4200130,Blair,0,1,0,1,0,2,6133
48031,G4800310,Blanco,0,0,1,0,0,1,325
01009,G0100090,Blount,0,0,1,0,0,1,2376
47009,G4700090,Blount,1,2,5,3,0,11,5046
27013,G2700130,Blue Earth,0,0,1,0,0,1,7529
28011,G2800110,Bolivar,0,1,4,6,0,11,2073
05009,G0500090,Boone,0,0,2,0,0,2,1464
17007,G1700070,Boone,0,0,0,1,0,1,2310
18011,G1800110,Boone,0,1,1,0,0,2,1880
21015,G2100150,Boone,0,0,1,1,0,2,4567
29019,G2900190,Boone,0,6,4,2,0,12,16196
54005,G5400050,Boone,0,0,0,1,0,1,952
22015,G2200150,Bossier,0,0,2,3,0,5,5735
51023,G5100230,Botetourt,0,0,1,0,0,1,1060
08013,G0800130,Boulder,0,1,8,8,0,17,22312
20011,G2000110,Bourbon,0,3,16,6,0,25,839
21017,G2100170,Bourbon,0,0,0,1,0,1,798
48037,G4800370,Bowie,1,3,13,8,0,25,4317
21019,G2100190,Boyd,0,0,0,1,0,1,1830
21021,G2100210,Boyle,0,1,2,2,0,5,1589
12007,G1200070,Bradford,0,0,1,1,0,2,1538
05011,G0500110,Bradley,0,2,3,3,0,8,527
47011,G4700110,Bradley,0,2,1,0,0,3,5079
48039,G4800390,Brazoria,0,6,18,13,0,37,13387
48041,G4800410,Brazos,0,1,15,5,0,21,31373
21025,G2100250,Breathitt,0,0,1,1,0,2,597
12009,G1200090,Brevard,2,7,12,13,0,34,23101
36005,G3600050,Bronx,0,0,1,3,0,4,81912
54009,G5400090,Brooke,0,0,1,0,0,1,1146
13027,G1300270,Brooks,0,0,0,1,0,1,712
36007,G3600070,Broome,0,0,3,1,0,4,13670
08014,G0800140,Broomfield,0,1,2,0,0,3,2288
12011,G1200110,Broward,4,57,158,113,0,332,74608
27015,G2700150,Brown,0,0,1,0,0,1,1206
46013,G4600130,Brown,0,0,1,0,0,1,1858
48049,G4800490,Brown,0,5,3,3,0,11,1766
55009,G5500090,Brown,0,0,0,1,0,1,12127
37019,G3700190,Brunswick,0,1,1,6,0,8,3393
40013,G4000130,Bryan,0,0,0,1,0,1,2550
29021,G2900210,Buchanan,0,0,2,0,0,2,5003
42017,G4200170,Bucks,0,3,12,6,0,21,24712
13031,G1300310,Bulloch,0,2,6,3,0,11,10168
37021,G3700210,Buncombe,0,3,2,1,0,6,10021
13033,G1300330,Burke,0,2,0,1,0,3,1064
37023,G3700230,Burke,0,0,2,0,0,2,4834
34005,G3400050,Burlington,0,0,3,4,0,7,20529
48053,G4800530,Burnet,0,2,0,2,0,4,1616
01013,G0100130,Butler,0,1,0,1,0,2,817
19023,G1900230,Butler,0,0,1,0,0,1,436
20015,G2000150,Butler,2,16,23,9,0,50,3279
39017,G3900170,Butler,1,3,16,5,0,25,20701
42019,G4200190,Butler,0,0,5,3,0,8,8421
06007,G0600070,Butte,0,3,11,9,0,23,16694
13035,G1300350,Butts,0,2,2,1,0,5,1360
37025,G3700250,Cabarrus,0,1,5,3,0,9,6749
54011,G5400110,Cabell,0,0,1,3,0,4,5766
49005,G4900050,Cache,0,1,0,12,0,13,9057
22017,G2200170,Caddo,1,7,14,18,0,40,12536
22019,G2200190,Calcasieu,1,3,5,5,0,14,9753
37027,G3700270,Caldwell,0,0,2,0,0,2,3259
01015,G0100150,Calhoun,0,2,2,1,0,5,6363
12013,G1200130,Calhoun,0,1,1,1,0,3,698
19025,G1900250,Calhoun,0,0,0,2,0,2,291
26025,G2600250,Calhoun,0,2,1,4,0,7,6306
45017,G4500170,Calhoun,0,2,4,1,0,7,627
48057,G4800570,Calhoun,0,0,1,0,0,1,933
29027,G2900270,Callaway,0,0,0,1,0,1,2676
21035,G2100350,Calloway,0,1,0,1,0,2,3559
55015,G5500150,Calumet,0,1,1,1,0,3,1675
24009,G2400090,Calvert,0,0,0,2,0,2,3769
42021,G4200210,Cambria,0,1,7,3,1,12,6847
13039,G1300390,Camden,0,4,7,3,0,14,3845
29029,G2900290,Camden,0,0,1,0,0,1,1467
34007,G3400070,Camden,0,6,15,11,0,32,23774
48061,G4800610,Cameron,0,0,2,1,0,3,20007
48063,G4800630,Camp,0,0,1,0,0,1,494
21037,G2100370,Campbell,0,2,1,4,0,7,4917
40017,G4000170,Canadian,0,1,2,2,0,5,4585
16027,G1600270,Canyon,0,0,2,3,0,5,8860
29031,G2900310,Cape Girardeau,0,1,0,1,0,2,5038
42025,G4200250,Carbon,0,0,0,2,0,2,2340
13045,G1300450,Carroll,0,0,8,1,0,9,6828
24013,G2400130,Carroll,0,0,2,0,0,2,7360
39019,G3900190,Carroll,0,1,0,0,0,1,1048
47017,G4700170,Carroll,1,0,1,1,0,3,1390
40019,G4000190,Carter,0,1,2,1,0,4,1852
47019,G4700190,Carter,0,1,0,0,0,1,2699
27019,G2700190,Carver,0,1,1,0,0,2,3056
30013,G3000130,Cascade,0,0,1,0,0,1,4287
19029,G1900290,Cass,0,0,1,0,0,1,454
29037,G2900370,Cass,0,3,5,1,0,9,3924
38017,G3800170,Cass,0,0,1,0,0,1,12532
48067,G4800670,Cass,0,0,2,3,0,5,1036
37035,G3700350,Catawba,0,0,5,2,0,7,6275
13047,G1300470,Catoosa,0,0,1,0,0,1,2647
36011,G3600110,Cayuga,0,0,1,1,0,2,3744
24015,G2400150,Cecil,1,1,3,0,0,5,4471
19031,G1900310,Cedar,0,0,1,0,0,1,615
42027,G4200270,Centre,0,3,1,1,0,5,24154
19033,G1900330,Cerro Gordo,0,1,2,1,0,4,1936
08015,G0800150,Chaffee,0,0,1,0,0,1,688
01017,G0100170,Chambers,0,1,0,1,0,2,1433
48071,G4800710,Chambers,0,0,2,0,0,2,1430
17019,G1700190,Champaign,1,0,3,2,0,6,25282
24017,G2400170,Charles,1,4,7,4,0,16,6537
45019,G4500190,Charleston,1,2,1,3,0,7,21355
12015,G1200150,Charlotte,2,1,2,1,0,6,4598
51540,G5105400,Charlottesville,0,1,1,1,0,3,5535
13049,G1300490,Charlton,0,3,2,1,0,6,731
13051,G1300510,Chatham,0,2,2,1,0,5,16878
37037,G3700370,Chatham,0,0,1,0,0,1,2075
13055,G1300550,Chattooga,0,0,2,0,0,2,1285
20019,G2000190,Chautauqua,0,0,0,1,0,1,129
35005,G3500050,Chaves,1,0,3,6,0,10,3489
47021,G4700210,Cheatham,0,0,0,1,0,1,1579
36017,G3600170,Chenango,1,13,14,6,0,34,2012
01019,G0100190,Cherokee,0,1,0,2,0,3,979
13057,G1300570,Cherokee,0,0,8,4,0,12,8444
40021,G4000210,Cherokee,0,0,3,0,0,3,3299
45021,G4500210,Cherokee,0,1,5,0,0,6,2593
48073,G4800730,Cherokee,0,0,2,3,0,5,2590
51550,G5105500,Chesapeake,0,7,9,11,0,27,10513
42029,G4200290,Chester,0,3,2,6,0,11,22404
45023,G4500230,Chester,0,1,3,0,0,4,1384
45025,G4500250,Chesterfield,0,1,2,2,0,5,2041
51041,G5100410,Chesterfield,0,0,1,0,0,1,13366
19037,G1900370,Chickasaw,0,0,0,1,0,1,429
28017,G2800170,Chickasaw,1,1,1,0,0,3,760
05017,G0500170,Chicot,0,0,0,2,0,2,552
48075,G4800750,Childress,0,0,0,1,0,1,611
01021,G0100210,Chilton,0,0,0,2,0,2,1900
01023,G0100230,Choctaw,0,0,0,2,0,2,513
28019,G2800190,Choctaw,0,1,0,0,0,1,324
21047,G2100470,Christian,0,0,4,0,0,4,6263
32001,G3200010,Churchill,0,0,1,0,0,1,1069
12017,G1200170,Citrus,0,0,0,1,0,1,4217
41005,G4100050,Clackamas,0,2,8,8,0,18,14964
22027,G2200270,Claiborne,0,0,0,1,0,1,941
28021,G2800210,Claiborne,0,0,0,3,0,3,784
45027,G4500270,Clarendon,0,4,2,0,0,6,2181
42031,G4200310,Clarion,0,0,0,1,0,1,2964
18019,G1800190,Clark,0,0,1,0,0,1,4535
32003,G3200030,Clark,1,12,34,54,0,101,91732
39023,G3900230,Clark,0,1,0,4,0,5,6140
53011,G5300110,Clark,0,2,7,1,0,10,17826
01025,G0100250,Clarke,0,2,1,3,0,6,1018
13059,G1300590,Clarke,0,1,7,1,0,9,15781
41007,G4100070,Clatsop,0,0,0,1,0,1,1763
01027,G0100270,Clay,0,0,1,3,0,4,547
12019,G1200190,Clay,0,1,7,1,0,9,8429
21051,G2100510,Clay,0,0,1,0,0,1,1057
28025,G2800250,Clay,0,1,2,1,0,4,930
29047,G2900470,Clay,0,2,12,4,0,18,8949
13063,G1300630,Clayton,0,9,20,15,0,44,13832
01029,G0100290,Cleburne,0,0,1,2,0,3,602
39025,G3900250,Clermont,0,0,1,0,0,1,7880
05025,G0500250,Cleveland,0,0,0,1,0,1,340
37045,G3700450,Cleveland,3,0,7,2,0,12,4447
40027,G4000270,Cleveland,0,4,16,7,0,27,18676
13065,G1300650,Clinch,0,0,2,1,0,3,331
19045,G1900450,Clinton,0,0,0,1,0,1,2030
26037,G2600370,Clinton,0,0,1,2,0,3,3911
39027,G3900270,Clinton,0,0,0,1,0,1,1986
42035,G4200350,Clinton,0,0,0,1,0,1,2963
28027,G2800270,Coahoma,1,1,5,5,0,12,1414
13067,G1300670,Cobb,1,15,51,22,0,89,32141
04003,G0400030,Cochise,0,1,2,0,0,3,6795
04005,G0400050,Coconino,0,0,2,1,0,3,11307
01031,G0100310,Coffee,0,1,1,3,0,5,2281
13069,G1300690,Coffee,0,0,2,4,0,6,2353
01033,G0100330,Colbert,0,3,2,0,0,5,2200
29051,G2900510,Cole,0,0,5,0,0,5,3510
17029,G1700290,Coles,0,0,1,0,0,1,5872
31037,G3100370,Colfax,0,0,1,0,0,1,529
12021,G1200210,Collier,0,8,13,15,0,36,11879
48085,G4800850,Collin,3,21,51,35,0,110,29164
48089,G4800890,Colorado,0,0,2,0,0,2,784
13071,G1300710,Colquitt,0,0,4,2,0,6,2410
05027,G0500270,Columbia,0,0,1,1,0,2,1723
12023,G1200230,Columbia,1,1,4,6,0,12,3901
13073,G1300730,Columbia,0,0,0,1,0,1,5188
42037,G4200370,Columbia,0,1,3,0,0,4,5040
55021,G5500210,Columbia,1,0,0,1,0,2,2072
39029,G3900290,Columbiana,0,0,1,2,0,3,4213
37047,G3700470,Columbus,0,0,4,1,0,5,2677
48091,G4800910,Comal,0,1,2,2,0,5,3882
40031,G4000310,Comanche,0,3,9,5,0,17,9738
01035,G0100350,Conecuh,0,0,0,2,0,2,543
06013,G0600130,Contra Costa,2,18,27,34,0,81,44920
56009,G5600090,Converse,0,0,0,1,0,1,531
05029,G0500290,Conway,0,0,2,0,0,2,828
13075,G1300750,Cook,0,0,1,0,0,1,780
17031,G1700310,Cook,3,28,84,57,0,172,256528
48097,G4800970,Cooke,0,0,1,1,0,2,1747
01037,G0100370,Coosa,0,0,0,1,0,1,431
28029,G2800290,Copiah,0,2,5,6,0,13,1702
48099,G4800990,Coryell,0,2,6,5,0,13,5209
39031,G3900310,Coshocton,0,1,0,0,0,1,1435
01039,G0100390,Covington,1,0,0,0,0,1,1471
28031,G2800310,Covington,0,1,2,2,0,5,872
13077,G1300770,Coweta,0,3,6,2,0,11,4905
20035,G2000350,Cowley,0,1,0,1,0,2,1956
40035,G4000350,Craig,0,0,1,0,0,1,616
05031,G0500310,Craighead,0,2,2,0,0,4,6253
37049,G3700490,Craven,0,2,6,4,0,12,7232
05033,G0500330,Crawford,0,0,2,1,0,3,2673
19047,G1900470,Crawford,0,0,1,0,0,1,849
20037,G2000370,Crawford,0,0,2,1,0,3,3614
39033,G3900330,Crawford,0,0,0,1,0,1,1684
42039,G4200390,Crawford,0,0,0,1,0,1,4096
40037,G4000370,Creek,0,1,0,2,0,3,2833
01041,G0100410,Crenshaw,0,0,3,3,0,6,591
13081,G1300810,Crisp,0,0,3,1,0,4,981
05035,G0500350,Crittenden,0,0,1,1,0,2,2167
47033,G4700330,Crockett,0,0,0,1,0,1,623
41013,G4100130,Crook,0,0,0,1,0,1,675
05037,G0500370,Cross,0,1,2,0,0,3,665
01043,G0100430,Cullman,0,1,1,2,0,4,3525
51047,G5100470,Culpeper,0,3,0,0,0,3,1969
23005,G2300050,Cumberland,0,0,1,0,0,1,12781
34011,G3400110,Cumberland,0,1,1,1,0,3,7932
37051,G3700510,Cumberland,0,10,7,10,0,27,21229
42041,G4200410,Cumberland,0,2,6,2,0,10,12675
31039,G3100390,Cuming,0,0,0,1,0,1,265
41015,G4100150,Curry,0,0,0,1,0,1,625
40039,G4000390,Custer,0,1,0,0,0,1,2449
39035,G3900350,Cuyahoga,5,27,83,61,0,176,56040
27037,G2700370,Dakota,0,1,11,0,0,12,15669
01045,G0100450,Dale,0,1,0,3,0,4,2528
01047,G0100470,Dallas,1,0,2,1,0,4,1866
19049,G1900490,Dallas,0,0,0,2,0,2,1976
48113,G4801130,Dallas,7,90,221,138,0,456,120627
55025,G5500250,Dane,0,1,6,7,0,14,31586
51590,G5105900,Danville,0,1,2,1,0,4,2026
45031,G4500310,Darlington,0,1,2,0,0,3,3046
42043,G4200430,Dauphin,1,10,8,12,0,31,11316
37057,G3700570,Davidson,0,1,2,1,0,4,6181
47037,G4700370,Davidson,2,10,13,21,0,46,35347
37059,G3700590,Davie,0,1,4,0,0,5,1340
21059,G2100590,Daviess,0,2,1,2,0,5,4172
49011,G4900110,Davis,0,2,3,7,0,12,14975
13085,G1300850,Dawson,0,0,2,1,0,3,905
31047,G3100470,Dawson,0,0,1,0,0,1,1038
22031,G2200310,De Soto,1,1,0,1,0,3,1093
01049,G0100490,DeKalb,0,0,1,1,0,2,2983
13089,G1300890,DeKalb,2,21,81,31,1,136,34607
17037,G1700370,DeKalb,0,0,0,1,0,1,11051
12027,G1200270,DeSoto,0,0,2,0,0,2,2479
28033,G2800330,DeSoto,2,8,8,11,0,29,6715
48123,G4801230,DeWitt,0,0,3,2,0,5,704
48117,G4801170,Deaf Smith,0,0,0,1,0,1,968
13087,G1300870,Decatur,0,1,3,1,0,5,1398
39039,G3900390,Defiance,0,0,0,1,0,1,1739
18035,G1800350,Delaware,0,0,2,3,0,5,10776
39041,G3900410,Delaware,0,4,3,3,0,10,5571
42045,G4200450,Delaware,0,1,2,4,0,7,29614
48121,G4801210,Denton,2,19,49,32,0,102,33869
08031,G0800310,Denver,0,11,19,13,0,43,30641
19057,G1900570,Des Moines,0,0,1,1,0,2,1505
41017,G4100170,Deschutes,0,0,1,0,1,2,6021
05041,G0500410,Desha,0,0,1,2,0,3,545
20041,G2000410,Dickinson,0,0,1,0,0,1,695
45033,G4500330,Dillon,0,1,5,0,0,6,1471
11001,G1100010,District of Columbia,3,16,27,19,0,65,39235
12029,G1200290,Dixie,0,1,1,0,0,2,657
13091,G1300910,Dodge,0,1,0,0,0,1,1320
55027,G5500270,Dodge,0,0,1,1,0,2,3981
20043,G2000430,Doniphan,0,0,8,0,0,8,544
13093,G1300930,Dooly,1,0,2,2,0,5,729
55029,G5500290,Door,0,1,0,0,0,1,839
45035,G4500350,Dorchester,1,1,1,1,0,4,5800
13095,G1300950,Dougherty,0,1,3,3,0,7,5754
08035,G0800350,Douglas,0,8,11,6,0,25,7926
13097,G1300970,Douglas,0,1,2,2,0,5,5695
17041,G1700410,Douglas,0,0,1,0,0,1,788
20045,G2000450,Douglas,0,2,1,0,0,3,14027
31055,G3100550,Douglas,0,9,17,12,0,38,26136
32005,G3200050,Douglas,0,0,0,1,0,1,1568
41019,G4100190,Douglas,0,1,0,1,0,2,4243
35013,G3500130,Doña Ana,0,0,2,3,0,5,13849
05043,G0500430,Drew,0,0,3,3,0,6,1204
17043,G1700430,DuPage,1,13,30,19,0,63,40560
18037,G1800370,Dubois,0,0,1,0,0,1,1503
19061,G1900610,Dubuque,0,0,0,1,0,1,5047
55033,G5500330,Dunn,0,0,0,1,0,1,4416
37061,G3700610,Duplin,0,0,0,1,0,1,2565
37063,G3700630,Durham,1,7,16,4,0,28,15441
36027,G3600270,Dutchess,0,1,1,0,0,2,16487
12031,G1200310,Duval,5,39,75,42,0,161,45869
47045,G4700450,Dyer,0,0,1,0,0,1,1487
13099,G1300990,Early,0,1,2,1,0,4,452
22033,G2200330,East Baton Rouge,2,11,25,25,0,63,30935
22037,G2200370,East Feliciana,0,2,1,0,0,3,1043
48133,G4801330,Eastland,0,1,1,2,0,4,1009
26045,G2600450,Eaton,0,1,1,3,0,5,4999
48135,G4801350,Ector,0,1,4,2,0,7,7658
35015,G3500150,Eddy,0,1,0,2,0,3,2427
37065,G3700650,Edgecombe,0,3,3,1,0,7,2346
45037,G4500370,Edgefield,0,0,1,1,0,2,1384
13103,G1301030,Effingham,0,0,1,0,0,1,2238
06017,G0600170,El Dorado,0,0,3,3,1,7,7304
08041,G0800410,El Paso,0,1,8,3,0,12,37000
48141,G4801410,El Paso,0,2,7,8,0,17,46300
13105,G1301050,Elbert,0,1,1,0,0,2,886
18039,G1800390,Elkhart,0,0,0,4,0,4,8817
32007,G3200070,Elko,0,0,0,1,0,1,2476
20051,G2000510,Ellis,0,0,0,1,0,1,2623
48139,G4801390,Ellis,0,6,8,11,0,25,6786
20053,G2000530,Ellsworth,0,0,0,1,0,1,364
01051,G0100510,Elmore,1,0,3,4,0,8,3801
16039,G1600390,Elmore,0,0,0,1,0,1,1928
13107,G1301070,Emanuel,0,2,1,1,0,4,1063
48143,G4801430,Erath,0,1,5,5,0,11,3501
36029,G3600290,Erie,0,1,3,13,0,17,49299
39043,G3900430,Erie,0,0,0,1,0,1,2883
42049,G4200490,Erie,0,4,9,4,0,17,16276
01053,G0100530,Escambia,0,2,2,2,0,6,1790
12033,G1200330,Escambia,1,7,18,16,0,42,20570
25009,G2500090,Essex,0,2,5,1,0,8,32778
34013,G3400130,Essex,0,1,5,7,0,13,37484
01055,G0100550,Etowah,1,2,5,5,0,13,4558
22039,G2200390,Evangeline,0,0,4,0,0,4,1819
51059,G5100590,Fairfax,0,10,14,16,0,40,43017
51600,G5106000,Fairfax,0,1,5,0,0,6,1208
09001,G0900010,Fairfield,0,5,2,4,0,11,37013
39045,G3900450,Fairfield,0,7,15,5,0,27,6102
45039,G4500390,Fairfield,0,1,1,0,0,2,942
48145,G4801450,Falls,0,0,2,3,0,5,888
05045,G0500450,Faulkner,0,1,1,1,0,3,8495
51061,G5100610,Fauquier,0,2,3,4,0,9,2430
01057,G0100570,Fayette,0,0,0,1,0,1,751
13113,G1301130,Fayette,0,6,18,11,0,35,3921
19065,G1900650,Fayette,0,1,1,0,0,2,1054
21067,G2100670,Fayette,0,2,11,11,0,24,20678
39047,G3900470,Fayette,0,1,1,0,0,2,1147
42051,G4200510,Fayette,1,0,1,1,0,3,5495
47047,G4700470,Fayette,0,0,2,0,0,2,1332
20055,G2000550,Finney,2,8,8,7,0,25,2141
12035,G1200350,Flagler,0,0,0,2,0,2,3057
30029,G3000290,Flathead,0,0,1,0,0,1,3406
45041,G4500410,Florence,0,3,2,3,0,8,6149
13115,G1301150,Floyd,0,3,4,2,0,9,4734
55039,G5500390,Fond du Lac,0,1,0,0,0,1,4613
20057,G2000570,Ford,0,3,6,5,0,14,1978
28035,G2800350,Forrest,0,3,9,6,0,18,5476
13117,G1301170,Forsyth,0,0,2,2,0,4,5254
37067,G3700670,Forsyth,0,3,11,4,0,18,16556
48157,G4801570,Fort Bend,0,15,41,28,0,84,24000
01059,G0100590,Franklin,0,2,2,2,0,6,1542
20059,G2000590,Franklin,0,0,1,0,0,1,1161
21073,G2100730,Franklin,0,0,3,1,0,4,2363
28037,G2800370,Franklin,0,2,5,0,0,7,306
29071,G2900710,Franklin,0,0,2,0,0,2,4317
37069,G3700690,Franklin,0,2,3,1,0,6,2710
39049,G3900490,Franklin,1,10,43,37,0,91,69598
42055,G4200550,Franklin,0,0,2,2,0,4,5915
48159,G4801590,Franklin,0,0,1,3,0,4,418
53021,G5300210,Franklin,0,1,2,0,0,3,4248
24021,G2400210,Frederick,0,4,4,9,0,17,9824
51069,G5100690,Frederick,0,0,1,0,0,1,3237
51630,G5106300,Fredericksburg,0,1,2,0,0,3,2222
16043,G1600430,Fremont,0,0,0,2,0,2,543
06019,G0600190,Fresno,3,18,41,48,0,110,55786
13121,G1301210,Fulton,4,29,79,47,0,159,49609
17057,G1700570,Fulton,0,0,1,0,0,1,1649
39051,G3900510,Fulton,0,1,0,0,0,1,1614
12039,G1200390,Gadsden,1,1,1,1,0,4,2037
31067,G3100670,Gage,0,0,1,0,0,1,823
30031,G3000310,Gallatin,0,0,0,1,0,1,7865
48167,G4801670,Galveston,0,8,20,31,0,59,13249
08045,G0800450,Garfield,0,0,0,1,0,1,2573
40047,G4000470,Garfield,0,1,4,2,0,7,2846
05051,G0500510,Garland,0,0,3,4,0,7,3743
40049,G4000490,Garvin,0,0,1,0,0,1,1062
37071,G3700710,Gaston,0,2,2,1,0,5,8883
20061,G2000610,Geary,0,0,0,1,0,1,2224
39055,G3900550,Geauga,0,0,1,1,0,2,3218
16045,G1600450,Gem,0,0,0,1,0,1,614
26049,G2600490,Genesee,0,4,11,8,0,23,18951
36037,G3600370,Genesee,0,0,0,1,0,1,2843
28039,G2800390,George,0,3,0,0,0,3,1072
18051,G1800510,Gibson,0,0,0,2,0,2,1358
47053,G4700530,Gibson,0,0,1,1,0,2,1794
48171,G4801710,Gillespie,0,0,0,1,0,1,739
12043,G1200430,Glades,0,0,0,1,0,1,630
34015,G3400150,Gloucester,0,6,12,6,1,25,13979
13127,G1301270,Glynn,0,1,0,4,0,5,3334
48175,G4801750,Goliad,0,0,0,1,0,1,243
51075,G5100750,Goochland,0,1,1,0,0,2,628
13129,G1301290,Gordon,1,0,4,1,0,6,2415
13131,G1301310,Grady,0,0,3,2,0,5,1123
40051,G4000510,Grady,0,0,1,2,0,3,2237
33009,G3300090,Grafton,0,0,0,1,0,1,6626
04009,G0400090,Graham,0,5,7,5,0,17,2384
49019,G4900190,Grand,0,0,1,0,0,1,314
26055,G2600550,Grand Traverse,0,3,3,0,0,6,3662
53025,G5300250,Grant,0,0,1,2,0,3,4816
55043,G5500430,Grant,0,0,2,0,1,3,5294
26057,G2600570,Gratiot,0,0,1,0,0,1,2704
21083,G2100830,Graves,0,1,0,0,0,1,1496
48181,G4801810,Grayson,0,3,7,5,0,15,5606
55045,G5500450,Green,0,0,0,2,0,2,1257
55047,G5500470,Green Lake,0,0,1,0,0,1,624
01063,G0100630,Greene,0,0,0,1,0,1,434
05055,G0500550,Greene,0,0,0,1,0,1,1873
13133,G1301330,Greene,0,1,0,0,0,1,541
29077,G2900770,Greene,1,0,3,0,0,4,18079
39057,G3900570,Greene,0,1,3,5,0,9,11415
21089,G2100890,Greenup,0,0,0,1,0,1,1351
45045,G4500450,Greenville,0,3,12,7,0,22,20919
45047,G4500470,Greenwood,1,3,5,1,0,10,3354
48183,G4801830,Gregg,2,5,18,14,0,39,6607
48185,G4801850,Grimes,0,1,4,1,0,6,1301
17063,G1700630,Grundy,0,1,6,2,0,9,1912
47061,G4700610,Grundy,0,0,1,0,0,1,515
48187,G4801870,Guadalupe,1,3,6,1,0,11,5626
37081,G3700810,Guilford,2,8,18,12,0,40,26528
12045,G1200450,Gulf,0,0,2,1,0,3,816
13135,G1301350,Gwinnett,0,28,69,32,0,129,36140
13137,G1301370,Habersham,0,1,1,0,0,2,1842
01065,G0100650,Hale,0,0,1,0,0,1,692
48189,G4801890,Hale,0,0,2,2,0,4,2273
37083,G3700830,Halifax,0,1,3,1,0,5,2336
51083,G5100830,Halifax,0,0,1,0,0,1,1257
13139,G1301390,Hall,1,7,19,9,0,36,8542
31079,G3100790,Hall,0,0,1,0,0,1,2511
47063,G4700630,Hamblen,0,0,3,0,0,3,2625
12047,G1200470,Hamilton,0,1,0,0,0,1,1436
18057,G1800570,Hamilton,0,0,8,5,0,13,7973
31081,G3100810,Hamilton,0,1,0,0,0,1,301
39061,G3900610,Hamilton,5,20,72,53,1,151,42135
47065,G4700650,Hamilton,1,5,5,4,1,16,16736
48193,G4801930,Hamilton,0,0,0,1,0,1,280
25013,G2500130,Hampden,0,0,1,0,0,1,24829
51650,G5106500,Hampton,1,9,9,4,0,23,8646
19081,G1900810,Hancock,0,0,1,0,0,1,332
21091,G2100910,Hancock,0,0,0,1,0,1,316
28045,G2800450,Hancock,0,0,0,1,0,1,1831
39063,G3900630,Hancock,0,0,0,1,0,1,3525
51085,G5100850,Hanover,0,1,1,0,0,2,4141
13143,G1301430,Haralson,0,1,0,0,0,1,1296
19083,G1900830,Hardin,0,0,3,3,0,6,824
21093,G2100930,Hardin,0,1,5,1,0,7,5837
39065,G3900650,Hardin,0,0,4,1,0,5,2542
47071,G4700710,Hardin,0,0,1,0,0,1,1007
48199,G4801990,Hardin,0,1,3,3,0,7,2322
54031,G5400310,Hardy,0,0,1,0,0,1,506
24025,G2400250,Harford,0,0,0,1,0,1,10618
37085,G3700850,Harnett,0,0,2,1,0,3,5712
13145,G1301450,Harris,0,2,0,1,0,3,1242
48201,G4802010,Harris,8,70,219,142,0,439,212866
19085,G1900850,Harrison,0,0,0,1,0,1,515
28047,G2800470,Harrison,0,4,6,4,0,14,10808
29081,G2900810,Harrison,0,1,1,0,0,2,309
48203,G4802030,Harrison,0,1,5,2,0,8,3041
54033,G5400330,Harrison,0,1,0,1,0,2,2532
51660,G5106600,Harrisonburg,0,1,1,0,0,2,8696
13147,G1301470,Hart,0,1,0,1,0,2,1036
09003,G0900030,Hartford,0,2,5,4,0,11,40625
20079,G2000790,Harvey,0,0,1,2,0,3,1516
15001,G1500010,Hawaii,0,1,5,2,0,8,7966
48209,G4802090,Hays,0,2,2,4,0,8,13640
37087,G3700870,Haywood,0,1,1,0,0,2,2142
47075,G4700750,Haywood,0,1,0,2,0,3,761
13149,G1301490,Heard,0,2,0,1,0,3,492
48211,G4802110,Hemphill,0,0,3,0,0,3,135
21101,G2101010,Henderson,0,0,1,0,0,1,1826
37089,G3700890,Henderson,0,0,1,0,0,1,3470
48213,G4802130,Henderson,0,6,10,6,0,22,3157
18063,G1800630,Hendricks,0,2,6,0,0,8,5417
12051,G1200510,Hendry,0,0,0,2,0,2,2453
27053,G2700530,Hennepin,0,8,32,19,0,59,56545
51087,G5100870,Henrico,1,3,10,3,0,17,12265
13151,G1301510,Henry,1,5,16,9,0,31,8383
19087,G1900870,Henry,0,0,2,0,0,2,968
39069,G3900690,Henry,0,0,0,1,0,1,1109
47079,G4700790,Henry,0,2,1,0,0,3,1122
51089,G5100890,Henry,0,0,1,0,0,1,1977
12053,G1200530,Hernando,0,1,1,0,0,2,5696
37091,G3700910,Hertford,0,1,2,0,0,3,1298
48215,G4802150,Hidalgo,0,1,1,1,0,3,41424
48217,G4802170,Hill,0,0,2,0,0,2,1480
12057,G1200570,Hillsborough,7,33,81,56,0,177,62905
33011,G3300110,Hillsborough,0,1,2,2,0,5,17606
26059,G2600590,Hillsdale,0,0,0,1,0,1,2283
28049,G2800490,Hinds,2,10,14,14,0,40,13703
37093,G3700930,Hoke,0,0,1,1,0,2,2008
28051,G2800510,Holmes,1,2,1,3,0,7,1161
15003,G1500030,Honolulu,2,13,62,63,0,140,53585
41027,G4100270,Hood River,0,0,0,1,0,1,925
21107,G2101070,Hopkins,0,0,1,1,0,2,1858
48223,G4802230,Hopkins,0,3,4,2,0,9,1514
45051,G4500510,Horry,0,3,9,2,0,14,13269
05059,G0500590,Hot Spring,0,0,1,0,0,1,1471
01069,G0100690,Houston,0,1,2,5,0,8,4152
13153,G1301530,Houston,0,6,5,6,0,17,6780
27055,G2700550,Houston,0,0,0,1,0,1,678
48225,G4802250,Houston,0,2,0,2,0,4,898
18067,G1800670,Howard,0,0,1,0,0,1,3205
24027,G2400270,Howard,0,0,0,2,0,2,11098
48227,G4802270,Howard,0,0,3,0,0,3,2203
34017,G3400170,Hudson,1,10,18,9,0,38,33123
06023,G0600230,Humboldt,1,1,1,1,0,4,8402
19091,G1900910,Humboldt,0,0,2,0,0,2,352
48231,G4802310,Hunt,0,0,1,3,0,4,4363
34019,G3400190,Hunterdon,0,0,1,0,0,1,5364
46067,G4600670,Hutchinson,0,0,1,0,0,1,199
48233,G4802330,Hutchinson,0,0,0,1,0,1,871
22045,G2200450,Iberia,0,4,4,4,0,12,3495
22047,G2200470,Iberville,0,0,2,1,0,3,1810
06025,G0600250,Imperial,0,0,1,3,0,4,10310
12061,G1200610,Indian River,0,2,6,1,0,9,4923
26065,G2600650,Ingham,0,1,2,6,0,9,26705
26067,G2600670,Ionia,0,1,0,0,0,1,3564
19095,G1900950,Iowa,0,1,0,0,0,1,505
37097,G3700970,Iredell,0,0,4,1,0,5,6714
17075,G1700750,Iroquois,0,0,0,1,0,1,1070
13155,G1301550,Irwin,0,1,0,1,0,2,476
53029,G5300290,Island,0,0,0,1,0,1,3861
51093,G5100930,Isle of Wight,0,1,0,0,0,1,1277
27061,G2700610,Itasca,0,0,1,0,0,1,1735
28057,G2800570,Itawamba,0,1,8,4,0,13,1352
01071,G0100710,Jackson,0,2,1,1,0,4,2135
12063,G1200630,Jackson,0,2,0,1,0,3,2708
13157,G1301570,Jackson,0,1,2,0,0,3,2455
20085,G2000850,Jackson,0,0,0,1,0,1,438
22049,G2200490,Jackson,0,2,1,2,0,5,797
26075,G2600750,Jackson,0,1,0,3,0,4,7776
28059,G2800590,Jackson,1,4,6,9,0,20,6132
29095,G2900950,Jackson,1,8,18,6,0,33,30816
40065,G4000650,Jackson,0,0,2,1,0,3,1523
41029,G4100290,Jackson,0,1,0,0,1,2,8642
48239,G4802390,Jackson,0,0,2,1,0,3,562
18073,G1800730,Jasper,0,0,0,1,0,1,1666
19099,G1900990,Jasper,0,0,0,1,0,1,1413
28061,G2800610,Jasper,0,1,1,1,0,3,693
29097,G2900970,Jasper,0,0,2,1,0,3,5978
48241,G4802410,Jasper,1,0,1,2,0,4,1335
01073,G0100730,Jefferson,4,19,44,37,0,104,31462
05069,G0500690,Jefferson,0,0,1,1,0,2,4250
08059,G0800590,Jefferson,0,1,10,8,0,19,24042
12065,G1200650,Jefferson,0,1,1,0,0,2,596
13163,G1301630,Jefferson,0,2,3,2,0,7,757
16051,G1600510,Jefferson,0,0,1,0,0,1,1052
21111,G2101110,Jefferson,0,12,28,22,0,62,33812
22051,G2200510,Jefferson,1,11,26,15,0,53,19998
29099,G2900990,Jefferson,0,1,0,0,0,1,9295
36045,G3600450,Jefferson,0,0,1,0,0,1,8137
39081,G3900810,Jefferson,0,1,3,0,0,4,3089
42065,G4200650,Jefferson,0,0,0,1,0,1,1889
47089,G4700890,Jefferson,0,0,0,1,0,1,2492
48245,G4802450,Jefferson,1,8,28,13,0,50,14029
22053,G2200530,Jefferson Davis,1,1,1,0,0,3,1350
28065,G2800650,Jefferson Davis,0,0,1,2,0,3,528
13165,G1301650,Jenkins,0,1,1,0,0,2,379
17083,G1700830,Jersey,0,0,0,1,0,1,1135
48249,G4802490,Jim Wells,0,0,1,1,0,2,1940
13167,G1301670,Johnson,0,0,2,0,0,2,447
18081,G1800810,Johnson,0,2,7,3,0,12,5863
19103,G1901030,Johnson,0,2,5,2,0,9,14126
20091,G2000910,Johnson,0,4,13,7,0,24,19574
48251,G4802510,Johnson,0,0,13,4,0,17,6726
37101,G3701010,Johnston,0,1,2,1,0,4,6479
13169,G1301690,Jones,0,0,1,1,0,2,1102
28067,G2800670,Jones,0,1,9,9,0,19,3360
48253,G4802530,Jones,0,0,0,1,0,1,1377
55057,G5500570,Juneau,0,0,0,1,0,1,1012
26077,G2600770,Kalamazoo,0,0,2,4,0,6,19254
54039,G5400390,Kanawha,0,0,2,2,0,4,7572
27067,G2700670,Kandiyohi,0,0,0,2,0,2,2147
17089,G1700890,Kane,0,0,2,3,0,5,22471
49025,G4900250,Kane,0,0,0,1,0,1,253
17091,G1700910,Kankakee,0,0,1,0,0,1,5735
48257,G4802570,Kaufman,0,2,5,7,0,14,4085
40071,G4000710,Kay,0,0,4,0,0,4,1993
28069,G2800690,Kemper,0,8,9,6,0,23,569
17093,G1700930,Kendall,1,0,2,2,0,5,4100
48259,G4802590,Kendall,0,0,1,2,0,3,1197
55059,G5500590,Kenosha,0,2,1,3,0,6,8496
10001,G1000010,Kent,0,1,3,0,0,4,8870
26081,G2600810,Kent,1,1,12,7,0,21,31294
44003,G4400030,Kent,0,1,0,0,0,1,6627
21117,G2101170,Kenton,0,0,2,2,0,4,7042
06029,G0600290,Kern,1,7,22,20,0,50,51013
48265,G4802650,Kerr,0,0,2,1,0,3,2006
45055,G4500550,Kershaw,0,1,2,2,0,5,2529
53033,G5300330,King,4,19,51,31,0,105,90214
40073,G4000730,Kingfisher,0,1,0,3,0,4,579
06031,G0600310,Kings,0,1,1,1,0,3,10410
36047,G3600470,Kings,1,2,3,3,0,9,132019
53035,G5300350,Kitsap,0,0,3,0,0,3,14701
48273,G4802730,Kleberg,0,0,1,2,0,3,3194
18083,G1800830,Knox,0,0,1,0,0,1,3145
31107,G3101070,Knox,0,0,0,1,0,1,246
47093,G4700930,Knox,0,1,9,7,0,17,25063
48275,G4802750,Knox,0,0,1,0,0,1,113
16055,G1600550,Kootenai,0,0,3,3,0,6,6102
18091,G1800910,LaPorte,0,0,1,0,0,1,5249
42069,G4200690,Lackawanna,0,2,7,9,0,18,10535
29105,G2901050,Laclede,0,0,0,1,0,1,1443
12067,G1200670,Lafayette,0,1,1,1,0,3,802
22055,G2200550,Lafayette,0,2,11,13,0,26,13656
28071,G2800710,Lafayette,0,1,6,4,0,11,6179
29107,G2901070,Lafayette,0,0,1,0,0,1,1373
22057,G2200570,Lafourche,0,3,2,1,0,6,4980
06033,G0600330,Lake,0,0,4,6,0,10,2617
12069,G1200690,Lake,0,6,9,4,0,19,10145
17097,G1700970,Lake,1,5,9,9,0,24,35565
18089,G1800890,Lake,1,0,5,9,0,15,21709
39085,G3900850,Lake,0,2,10,6,0,18,8862
13171,G1301710,Lamar,0,0,1,0,0,1,1233
28073,G2800730,Lamar,0,2,1,2,0,5,3039
48277,G4802770,Lamar,1,0,3,2,0,6,2248
48281,G4802810,Lampasas,0,0,2,1,0,3,780
31109,G3101090,Lancaster,1,3,7,5,1,17,21566
42071,G4200710,Lancaster,0,3,6,1,0,10,25396
41039,G4100390,Lane,0,2,5,5,0,12,22495
13173,G1301730,Lanier,0,0,1,0,0,1,483
26087,G2600870,Lapeer,0,1,0,1,0,2,3792
56021,G5600210,Laramie,0,0,0,1,0,1,4638
08069,G0800690,Larimer,1,0,4,10,0,15,21072
06035,G0600350,Lassen,0,0,0,2,0,2,2759
01077,G0100770,Lauderdale,0,0,3,5,0,8,5011
28075,G2800750,Lauderdale,0,4,3,4,0,11,4036
47097,G4700970,Lauderdale,0,0,1,3,0,4,1469
13175,G1301750,Laurens,0,1,4,4,0,9,2041
01079,G0100790,Lawrence,0,0,2,1,0,3,1446
05075,G0500750,Lawrence,0,1,0,2,0,3,801
21127,G2101270,Lawrence,0,0,0,1,0,1,675
28077,G2800770,Lawrence,0,1,1,1,0,3,545
39087,G3900870,Lawrence,0,0,2,0,0,2,2485
42073,G4200730,Lawrence,0,1,2,0,0,3,3789
46081,G4600810,Lawrence,0,0,0,1,0,1,1607
28079,G2800790,Leake,0,0,0,2,0,2,1107
42075,G4200750,Lebanon,0,2,2,1,0,5,5573
01081,G0100810,Lee,1,5,5,9,0,20,14694
12071,G1200710,Lee,2,9,24,13,0,48,24029
13177,G1301770,Lee,0,1,1,0,0,2,1180
28081,G2800810,Lee,0,3,2,3,0,8,3372
37105,G3701050,Lee,0,0,1,1,0,2,2519
48287,G4802870,Lee,0,1,4,1,0,6,748
28083,G2800830,Leflore,0,1,0,1,0,2,1866
42077,G4200770,Lehigh,0,1,2,1,0,4,14988
26091,G2600910,Lenawee,0,1,2,0,0,3,5042
12073,G1200730,Leon,3,32,55,18,0,108,28906
12075,G1200750,Levy,0,0,1,2,0,3,1560
29111,G2901110,Lewis,0,1,0,0,0,1,614
53041,G5300410,Lewis,0,0,0,1,0,1,3350
30049,G3000490,Lewis and Clark,0,0,1,0,0,1,2769
45063,G4500630,Lexington,1,3,1,3,0,8,11591
51678,G5106780,Lexington,0,0,3,0,0,3,2137
12077,G1200770,Liberty,0,0,0,1,0,1,465
13179,G1301790,Liberty,0,0,1,0,0,1,4744
48291,G4802910,Liberty,0,3,4,5,0,12,3524
39089,G3900890,Licking,0,1,0,2,0,3,7285
01083,G0100830,Limestone,0,4,7,5,0,16,3475
48293,G4802930,Limestone,0,0,1,1,0,2,1247
13181,G1301810,Lincoln,0,0,2,0,0,2,318
22061,G2200610,Lincoln,0,1,2,0,0,3,5801
28085,G2800850,Lincoln,0,0,2,3,0,5,1450
31111,G3101110,Lincoln,0,0,0,2,0,2,1457
32017,G3200170,Lincoln,0,0,1,1,0,2,267
35027,G3500270,Lincoln,0,0,0,1,0,1,626
40081,G4000810,Lincoln,0,0,1,0,0,1,1315
41041,G4100410,Lincoln,0,0,1,0,0,1,1662
46083,G4600830,Lincoln,0,0,1,0,0,1,1411
47103,G4701030,Lincoln,0,0,0,1,0,1,1341
55069,G5500690,Lincoln,0,0,1,0,0,1,960
19113,G1901130,Linn,0,3,3,4,0,10,10411
20107,G2001070,Linn,0,0,1,0,0,1,306
29115,G2901150,Linn,0,0,1,0,0,1,428
41043,G4100430,Linn,0,0,1,1,0,2,4939
09005,G0900050,Litchfield,0,0,1,2,0,3,6698
05081,G0500810,Little River,0,0,1,1,0,2,530
17105,G1701050,Livingston,0,0,1,1,0,2,1704
22063,G2200630,Livingston,0,3,2,2,0,7,5742
26093,G2600930,Livingston,0,0,1,0,0,1,6694
05083,G0500830,Logan,0,1,0,0,0,1,887
40083,G4000830,Logan,0,1,1,0,0,2,2251
39093,G3900930,Lorain,1,2,7,10,0,20,13151
06037,G0600370,Los Angeles,15,177,376,327,0,895,543300
51107,G5101070,Loudoun,1,4,7,3,0,15,9560
40085,G4000850,Love,0,0,0,1,0,1,350
13185,G1301850,Lowndes,2,4,9,5,0,20,9230
28087,G2800870,Lowndes,0,2,6,7,0,15,3054
48303,G4803030,Lubbock,1,1,6,4,0,12,24352
39095,G3900950,Lucas,1,6,13,11,0,31,24179
42079,G4200790,Luzerne,0,3,2,6,0,11,15562
42081,G4200810,Lycoming,0,1,2,1,0,4,7170
51680,G5106800,Lynchburg,0,3,4,7,0,14,8067
19119,G1901190,Lyon,0,0,1,0,0,1,393
20111,G2001110,Lyon,0,1,0,0,0,1,2508
26097,G2600970,Mackinac,0,0,0,1,0,1,331
26099,G2600990,Macomb,0,2,5,9,0,16,35808
13193,G1301930,Macon,0,0,1,0,0,1,887
17115,G1701150,Macon,0,2,1,2,0,5,4944
37113,G3701130,Macon,0,0,0,1,0,1,1349
01089,G0100890,Madison,0,4,11,7,0,22,17714
12079,G1200790,Madison,1,5,2,2,0,10,988
16065,G1600650,Madison,1,0,1,3,0,5,5718
17119,G1701190,Madison,0,1,4,1,0,6,13716
18095,G1800950,Madison,0,0,1,1,0,2,6049
21151,G2101510,Madison,0,0,2,2,0,4,6593
28089,G2800890,Madison,0,4,6,1,0,11,3931
36053,G3600530,Madison,0,0,1,0,0,1,4905
39097,G3900970,Madison,0,0,0,1,0,1,2165
47113,G4701130,Madison,0,2,3,1,0,6,5237
48313,G4803130,Madison,0,1,1,2,0,4,1117
19123,G1901230,Mahaska,0,0,1,0,0,1,1169
39099,G3900990,Mahoning,0,12,17,17,1,47,10415
51683,G5106830,Manassas,0,3,0,0,0,3,1883
12081,G1200810,Manatee,0,13,11,12,0,36,11663
55071,G5500710,Manitowoc,0,0,0,1,0,1,3156
55073,G5500730,Marathon,0,0,4,2,0,6,5552
01091,G0100910,Marengo,0,0,3,2,0,5,910
04013,G0400130,Maricopa,4,48,108,97,0,257,195125
06041,G0600410,Marin,0,1,1,1,0,3,8022
12083,G1200830,Marion,0,9,9,8,0,26,12006
13197,G1301970,Marion,0,0,0,1,0,1,432
18097,G1800970,Marion,1,15,36,13,0,65,45338
28091,G2800910,Marion,0,1,1,2,0,4,1156
39101,G3901010,Marion,0,0,1,2,0,3,3271
41047,G4100470,Marion,0,0,1,3,0,4,15934
45067,G4500670,Marion,0,0,2,0,0,2,1308
48315,G4803150,Marion,0,0,2,0,0,2,350
54049,G5400490,Marion,0,0,0,1,0,1,2894
45069,G4500690,Marlboro,0,2,3,0,0,5,1348
01095,G0100950,Marshall,0,0,1,1,0,2,4293
18099,G1800990,Marshall,0,0,1,1,0,2,1957
20117,G2001170,Marshall,0,0,0,1,0,1,329
28093,G2800930,Marshall,0,0,0,1,0,1,1785
40095,G4000950,Marshall,0,0,1,0,0,1,542
47117,G4701170,Marshall,0,1,0,1,0,2,1187
12085,G1200850,Martin,0,0,1,1,0,2,5094
27091,G2700910,Martin,0,0,1,0,0,1,720
37117,G3701170,Martin,0,1,0,1,0,2,920
48317,G4803170,Martin,0,0,1,1,0,2,204
53045,G5300450,Mason,0,0,2,1,0,3,2581
48321,G4803210,Matagorda,0,2,1,3,0,6,1624
02170,G0201700,Matanuska-Susitna,0,0,0,2,0,2,3935
15009,G1500090,Maui,0,1,1,4,0,6,6002
47119,G4701190,Maury,0,0,3,1,0,4,3346
40087,G4000870,McClain,0,0,1,1,0,2,1247
21145,G2101450,McCracken,0,0,1,2,0,3,2333
13189,G1301890,McDuffie,0,1,4,0,0,5,901
17111,G1701110,McHenry,0,3,2,2,0,7,12418
13191,G1301910,McIntosh,0,1,0,1,0,2,517
40091,G4000910,McIntosh,0,0,0,1,0,1,633
42083,G4200830,McKean,0,0,0,1,0,1,2105
17113,G1701130,McLean,0,1,3,2,0,6,13703
48309,G4803090,McLennan,0,8,18,7,0,33,16125
27085,G2700850,McLeod,0,1,1,0,0,2,1453
47107,G4701070,McMinn,0,0,1,0,0,1,2075
20113,G2001130,McPherson,0,1,1,1,0,3,1348
21163,G2101630,Meade,0,0,1,0,0,1,1318
37119,G3701190,Mecklenburg,3,20,44,26,0,93,43945
26107,G2601070,Mecosta,0,0,1,0,0,1,4801
39103,G3901030,Medina,0,1,1,4,0,6,6119
48325,G4803250,Medina,0,0,1,0,0,1,2608
27093,G2700930,Meeker,0,0,1,0,0,1,846
06045,G0600450,Mendocino,0,0,0,1,0,1,3769
06047,G0600470,Merced,1,2,5,4,0,12,15860
34021,G3400210,Mercer,1,6,15,6,0,28,20264
39107,G3901070,Mercer,0,1,2,4,0,7,1682
42085,G4200850,Mercer,0,0,1,2,0,3,5585
13199,G1301990,Meriwether,0,0,2,0,0,2,919
08077,G0800770,Mesa,0,0,3,1,0,4,7461
20121,G2001210,Miami,0,0,0,1,0,1,1088
39109,G3901090,Miami,0,4,4,2,0,10,4009
12086,G1200860,Miami-Dade,6,93,145,124,2,370,124922
09007,G0900070,Middlesex,0,1,1,1,0,3,6627
25017,G2500170,Middlesex,0,1,9,5,0,15,72332
34023,G3400230,Middlesex,0,8,13,10,0,31,43057
51119,G5101190,Middlesex,0,0,1,0,0,1,384
26111,G2601110,Midland,0,2,0,2,0,4,4134
48329,G4803290,Midland,0,1,8,6,0,15,6744
48331,G4803310,Milam,0,1,1,3,0,5,905
49027,G4900270,Millard,0,0,0,2,0,2,498
05091,G0500910,Miller,0,0,3,0,0,3,2044
13201,G1302010,Miller,1,0,0,1,0,2,276
55079,G5500790,Milwaukee,1,6,9,9,0,25,53535
30061,G3000610,Mineral,0,0,1,0,0,1,132
54057,G5400570,Mineral,0,0,0,1,0,1,1425
54059,G5400590,Mingo,0,0,0,2,0,2,999
16067,G1600670,Minidoka,0,0,0,1,0,1,942
46099,G4600990,Minnehaha,0,1,1,1,0,3,8424
05093,G0500930,Mississippi,0,1,1,3,0,5,2160
13205,G1302050,Mitchell,0,1,0,0,0,1,1246
01097,G0100970,Mobile,1,19,39,30,0,89,20093
04015,G0400150,Mohave,0,0,0,1,0,1,6918
34025,G3400250,Monmouth,0,5,11,11,0,27,25788
54061,G5400610,Monongalia,0,0,4,4,0,8,13888
12087,G1200870,Monroe,0,1,3,1,0,5,2756
13207,G1302070,Monroe,0,0,0,4,0,4,1222
18105,G1801050,Monroe,0,0,2,3,0,5,20339
21171,G2101710,Monroe,0,0,1,0,0,1,429
26115,G2601150,Monroe,0,0,1,3,0,4,6595
28095,G2800950,Monroe,0,1,1,1,0,3,1584
36055,G3600550,Monroe,0,4,5,10,0,19,42731
42089,G4200890,Monroe,0,1,2,3,0,6,9154
06053,G0600530,Monterey,0,1,7,10,0,18,24951
01101,G0101010,Montgomery,0,4,3,11,0,18,12939
20125,G2001250,Montgomery,2,14,21,14,0,51,1817
24031,G2400310,Montgomery,3,19,25,11,0,58,37515
28097,G2800970,Montgomery,0,0,2,0,0,2,435
36057,G3600570,Montgomery,0,1,0,0,0,1,2106
39113,G3901130,Montgomery,0,21,32,24,0,77,25386
42091,G4200910,Montgomery,1,2,6,9,0,18,31089
47125,G4701250,Montgomery,0,1,0,1,0,2,10580
48339,G4803390,Montgomery,0,1,21,12,0,34,18752
51121,G5101210,Montgomery,0,0,0,1,0,1,16517
37125,G3701250,Moore,0,0,2,0,0,2,2789
22067,G2200670,Morehouse,1,5,5,6,0,17,1204
01103,G0101030,Morgan,0,3,7,1,0,11,5209
08087,G0800870,Morgan,0,0,1,0,0,1,1200
18109,G1801090,Morgan,0,0,0,1,0,1,2697
34027,G3400270,Morris,0,0,4,4,0,8,18240
48343,G4803430,Morris,0,2,2,2,0,6,481
41051,G4100510,Multnomah,1,7,9,11,1,29,35041
13213,G1302130,Murray,0,0,1,0,0,1,1814
19139,G1901390,Muscatine,0,0,1,3,0,4,1772
13215,G1302150,Muscogee,1,13,14,10,0,38,11208
26121,G2601210,Muskegon,1,2,3,1,0,7,7949
39119,G3901190,Muskingum,0,0,2,2,0,4,3869
40101,G4001010,Muskogee,0,3,4,3,0,10,3400
48347,G4803470,Nacogdoches,0,0,1,1,0,2,5757
06055,G0600550,Napa,0,0,2,0,0,2,6390
37127,G3701270,Nash,0,1,4,1,0,6,4050
12089,G1200890,Nassau,0,1,2,0,0,3,2950
36059,G3600590,Nassau,0,3,6,9,0,18,58445
22069,G2200690,Natchitoches,0,0,0,1,0,1,2727
04017,G0400170,Navajo,0,0,1,1,0,2,5330
48349,G4803490,Navarro,0,4,12,8,0,24,2197
51125,G5101250,Nelson,0,0,1,0,0,1,478
28099,G2800990,Neshoba,1,1,2,3,0,7,1265
06057,G0600570,Nevada,0,0,3,2,0,5,3466
10003,G1000030,New Castle,0,3,14,8,1,26,29154
37129,G3701290,New Hanover,0,2,5,5,0,12,12264
09009,G0900090,New Haven,0,1,9,6,0,16,42597
09011,G0900110,New London,0,2,2,3,0,7,15157
29143,G2901430,New Madrid,0,1,2,1,0,4,764
36061,G3600610,New York,0,2,0,2,0,4,79317
45071,G4500710,Newberry,0,0,1,0,0,1,1996
44005,G4400050,Newport,0,0,0,1,0,1,3862
51700,G5107000,Newport News,2,1,3,4,0,10,12289
13217,G1302170,Newton,0,0,3,2,0,5,4430
28101,G2801010,Newton,0,2,2,4,0,8,1051
48351,G4803510,Newton,0,0,1,2,0,3,750
36063,G3600630,Niagara,0,0,1,3,0,4,10168
40103,G4001030,Noble,0,1,0,0,0,1,401
48353,G4803530,Nolan,0,0,1,0,0,1,755
25021,G2500210,Norfolk,0,1,5,3,0,9,25971
51710,G5107100,Norfolk,0,6,9,7,0,22,28602
37131,G3701310,Northampton,0,0,1,0,0,1,911
42095,G4200950,Northampton,0,2,8,7,0,17,15526
42097,G4200970,Northumberland,0,0,2,3,0,5,3935
40105,G4001050,Nowata,0,0,1,0,0,1,384
28103,G2801030,Noxubee,0,3,3,0,0,6,574
48355,G4803550,Nueces,0,0,5,5,0,10,17438
19141,G1901410,O'Brien,0,0,0,1,0,1,515
26125,G2601250,Oakland,1,19,39,32,0,91,46478
34029,G3400290,Ocean,0,2,2,2,0,6,22129
13219,G1302190,Oconee,0,2,0,0,0,2,1188
26129,G2601290,Ogemaw,0,1,0,0,0,1,748
17141,G1701410,Ogle,0,0,0,2,0,2,2104
54069,G5400690,Ohio,0,0,1,0,0,1,2365
12091,G1200910,Okaloosa,0,2,9,6,0,17,10146
12093,G1200930,Okeechobee,0,1,0,1,0,2,2073
40109,G4001090,Oklahoma,1,8,29,14,0,52,37599
40111,G4001110,Okmulgee,0,1,1,1,0,3,2165
28105,G2801050,Oktibbeha,0,0,3,6,0,9,7633
27109,G2701090,Olmsted,0,0,0,1,0,1,5491
36065,G3600650,Oneida,0,0,0,1,0,1,12380
36067,G3600670,Onondaga,0,4,4,7,0,15,25454
37133,G3701330,Onslow,1,2,2,2,0,7,27199
36069,G3600690,Ontario,0,1,0,0,0,1,4953
06059,G0600590,Orange,9,43,109,99,0,260,157491
12095,G1200950,Orange,5,21,60,39,0,125,74236
36071,G3600710,Orange,0,0,0,1,0,1,20340
37135,G3701350,Orange,0,1,0,0,0,1,11023
48361,G4803610,Orange,0,4,6,8,0,18,3665
51137,G5101370,Orange,0,2,0,1,0,3,1148
45075,G4500750,Orangeburg,0,1,5,1,0,7,5317
22071,G2200710,Orleans,1,18,36,43,0,98,20725
36073,G3600730,Orleans,0,0,0,1,0,1,2055
20139,G2001390,Osage,0,0,0,1,0,1,549
40113,G4001130,Osage,0,1,2,3,0,6,1851
12097,G1200970,Osceola,0,1,5,3,0,9,13451
36075,G3600750,Oswego,0,0,0,3,0,3,7739
36077,G3600770,Otsego,0,0,1,0,0,1,4755
26139,G2601390,Ottawa,0,1,1,7,0,9,15969
40115,G4001150,Ottawa,0,3,12,5,0,20,1567
27111,G2701110,Otter Tail,0,0,1,0,0,1,2034
05103,G0501030,Ouachita,0,1,6,4,0,11,1065
22073,G2200730,Ouachita,0,12,15,17,0,44,8363
55087,G5500870,Outagamie,0,0,2,2,0,4,8033
16073,G1600730,Owyhee,0,0,0,1,0,1,516
55089,G5500890,Ozaukee,0,1,0,3,0,4,3278
19145,G1901450,Page,0,0,1,0,0,1,640
12099,G1200990,Palm Beach,5,43,92,61,0,201,54936
48363,G4803630,Palo Pinto,0,0,1,0,0,1,1125
28107,G2801070,Panola,0,7,10,1,0,18,1589
48365,G4803650,Panola,0,4,5,1,0,10,1056
48367,G4803670,Parker,1,2,5,2,0,10,5281
12101,G1201010,Pasco,0,3,9,1,0,13,16495
34031,G3400310,Passaic,0,4,9,9,1,23,26171
13223,G1302230,Paulding,0,0,7,3,0,10,5784
40117,G4001170,Pawnee,0,0,1,0,0,1,604
16075,G1600750,Payette,0,0,1,0,0,1,884
40119,G4001190,Payne,0,0,1,1,0,2,10581
13225,G1302250,Peach,0,5,4,1,0,10,2279
28109,G2801090,Pearl River,0,2,14,7,0,23,2640
29155,G2901550,Pemiscot,0,0,1,1,0,2,770
17143,G1701430,Peoria,0,1,2,1,0,4,9299
21193,G2101930,Perry,0,0,0,1,0,1,1288
28111,G2801110,Perry,0,0,2,0,0,2,499
37145,G3701450,Person,0,0,2,1,0,3,1537
51730,G5107300,Petersburg,0,1,0,0,0,1,1746
29159,G2901590,Pettis,0,0,1,0,0,1,1971
42101,G4201010,Philadelphia,1,8,21,13,0,43,99046
08095,G0800950,Phillips,0,0,1,0,0,1,154
20147,G2001470,Phillips,0,0,1,0,0,1,185
30071,G3000710,Phillips,0,0,1,0,0,1,123
01107,G0101070,Pickens,0,1,4,1,0,6,857
45077,G4500770,Pickens,0,4,4,0,0,8,11705
13229,G1302290,Pierce,0,0,1,0,0,1,715
31139,G3101390,Pierce,0,0,1,0,0,1,227
53053,G5300530,Pierce,1,9,22,17,0,49,40053
01109,G0101090,Pike,0,0,2,7,0,9,3357
28113,G2801130,Pike,0,0,7,3,0,10,1784
42103,G4201030,Pike,0,1,0,0,0,1,2178
04019,G0400190,Pima,1,2,17,10,0,30,54859
04021,G0400210,Pinal,0,0,2,1,0,3,16791
12103,G1201030,Pinellas,2,10,40,26,1,79,33364
37147,G3701470,Pitt,0,1,3,2,0,6,13951
40121,G4001210,Pittsburg,0,1,0,0,0,1,1963
51143,G5101430,Pittsylvania,11,45,35,16,0,107,2390
06061,G0600610,Placer,2,6,7,11,0,26,13860
22075,G2200750,Plaquemines,0,2,2,0,0,4,982
29165,G2901650,Platte,0,2,3,4,0,9,3497
31141,G3101410,Platte,0,1,0,0,0,1,1351
06063,G0600630,Plumas,0,0,2,2,0,4,798
25023,G2500230,Plymouth,0,1,2,3,0,6,20377
05111,G0501110,Poinsett,0,0,2,2,0,4,1045
22077,G2200770,Pointe Coupee,0,0,0,2,0,2,911
12105,G1201050,Polk,1,21,37,18,0,77,26867
13233,G1302330,Polk,0,0,2,2,0,4,1951
19153,G1901530,Polk,0,4,9,10,0,23,19409
41053,G4100530,Polk,0,0,2,2,0,4,4293
48373,G4803730,Polk,0,0,3,0,0,3,2032
55095,G5500950,Polk,0,0,0,1,0,1,1444
28115,G2801150,Pontotoc,0,0,1,0,0,1,1321
40123,G4001230,Pontotoc,0,0,2,0,0,2,2448
05115,G0501150,Pope,0,1,2,3,0,6,4694
39133,G3901330,Portage,0,1,2,4,0,7,11842
18127,G1801270,Porter,0,0,1,2,0,3,7634
51740,G5107400,Portsmouth,0,0,1,0,0,1,5143
18129,G1801290,Posey,0,0,0,1,0,1,1086
40125,G4001250,Pottawatomie,0,0,0,1,0,1,3390
19155,G1901550,Pottawattamie,1,1,13,5,0,20,4454
48375,G4803750,Potter,0,0,4,2,0,6,6090
05117,G0501170,Prairie,0,0,0,1,0,1,309
20151,G2001510,Pratt,0,0,1,0,0,1,551
39135,G3901350,Preble,0,0,1,0,0,1,1642
28117,G2801170,Prentiss,1,1,2,8,0,12,1456
51149,G5101490,Prince George,0,0,1,0,0,1,1880
24033,G2400330,Prince George's,4,25,47,31,0,107,52655
51153,G5101530,Prince William,1,3,8,7,0,19,17876
05119,G0501190,Pulaski,2,10,16,14,0,42,17928
13235,G1302350,Pulaski,0,1,3,1,0,5,349
21199,G2101990,Pulaski,0,0,1,2,1,4,2396
51155,G5101550,Pulaski,0,0,2,0,0,2,1290
12107,G1201070,Putnam,0,1,3,1,0,5,3170
36081,G3600810,Queens,0,0,9,8,0,17,111522
55101,G5501010,Racine,0,1,0,1,0,2,8445
48379,G4803790,Rains,0,0,0,1,0,1,387
54081,G5400810,Raleigh,0,0,0,3,0,3,3274
27123,G2701230,Ramsey,2,5,11,1,0,19,29878
48381,G4803810,Randall,0,0,0,1,0,1,6464
01111,G0101110,Randolph,0,1,1,2,0,4,913
05121,G0501210,Randolph,0,1,0,0,0,1,767
17157,G1701570,Randolph,0,0,0,1,0,1,1577
28121,G2801210,Rankin,1,1,5,7,0,14,5582
22079,G2200790,Rapides,0,2,1,2,0,5,5909
30081,G3000810,Ravalli,0,0,0,1,0,1,1304
29177,G2901770,Ray,0,0,1,0,0,1,925
48383,G4803830,Reagan,0,0,0,1,0,1,153
22081,G2200810,Red River,0,0,1,0,0,1,400
48387,G4803870,Red River,0,0,1,3,0,4,434
31145,G3101450,Red Willow,0,0,2,1,0,3,538
48391,G4803910,Refugio,0,0,0,1,0,1,306
20155,G2001550,Reno,0,6,10,5,0,21,3220
36083,G3600830,Rensselaer,0,0,2,1,0,3,10375
27131,G2701310,Rice,0,1,0,1,0,2,4750
22083,G2200830,Richland,0,3,1,0,0,4,922
38077,G3800770,Richland,0,3,2,0,0,5,1245
39139,G3901390,Richland,0,0,1,2,0,3,5770
45079,G4500790,Richland,0,9,18,8,0,35,30691
55103,G5501030,Richland,0,0,0,1,0,1,700
13245,G1302450,Richmond,0,0,6,2,0,8,13065
36085,G3600850,Richmond,1,2,5,3,0,11,22661
37153,G3701530,Richmond,0,3,3,1,0,7,2303
51760,G5107600,Richmond,2,8,17,9,0,36,17180
06065,G0600650,Riverside,4,32,79,55,0,170,117847
47145,G4701450,Roane,0,0,1,2,0,3,1874
51770,G5107700,Roanoke,0,1,3,2,0,6,4040
47147,G4701470,Robertson,0,0,0,1,0,1,2685
48395,G4803950,Robertson,0,1,0,1,0,2,643
37155,G3701550,Robeson,0,1,2,2,0,5,7462
55105,G5501050,Rock,0,0,1,1,0,2,6965
17161,G1701610,Rock Island,0,0,0,3,0,3,6748
21203,G2102030,Rockcastle,0,0,1,0,0,1,689
13247,G1302470,Rockdale,0,2,3,5,0,10,3969
37157,G3701570,Rockingham,0,0,0,1,0,1,3570
36087,G3600870,Rockland,0,0,0,8,0,8,14473
48397,G4803970,Rockwall,0,3,11,8,0,22,2631
40131,G4001310,Rogers,0,0,3,2,0,5,3848
39141,G3901410,Ross,0,0,0,3,0,3,3312
08107,G0801070,Routt,0,0,1,0,0,1,1130
37159,G3701590,Rowan,0,0,2,1,0,3,6391
48401,G4804010,Rusk,0,0,6,4,0,10,2820
01113,G0101130,Russell,0,1,6,3,0,10,2414
37161,G3701610,Rutherford,0,1,0,0,0,1,2571
47149,G4701490,Rutherford,0,1,8,5,0,14,16576
22085,G2200850,Sabine,0,0,1,0,0,1,994
06067,G0600670,Sacramento,1,17,27,31,0,76,72464
26145,G2601450,Saginaw,1,3,3,2,0,9,10517
34033,G3400330,Salem,0,1,1,1,0,3,2798
51775,G5107750,Salem,0,0,1,1,0,2,1587
05125,G0501250,Saline,0,0,0,1,0,1,3950
20169,G2001690,Saline,0,0,2,0,0,2,2727
31151,G3101510,Saline,0,1,1,0,0,2,958
49035,G4900350,Salt Lake,1,7,31,27,0,66,55724
06069,G0600690,San Benito,0,0,0,1,0,1,2694
06071,G0600710,San Bernardino,1,35,70,60,1,167,119174
06073,G0600730,San Diego,2,36,86,101,0,225,200607
06075,G0600750,San Francisco,2,20,22,17,0,61,37296
48407,G4804070,San Jacinto,0,0,2,0,0,2,1040
06077,G0600770,San Joaquin,0,7,15,12,0,34,37155
35045,G3500450,San Juan,0,1,0,0,0,1,6472
06079,G0600790,San Luis Obispo,0,2,6,5,0,13,21965
06081,G0600810,San Mateo,0,3,12,14,0,29,29257
48409,G4804090,San Patricio,0,0,1,3,0,4,2928
35043,G3500430,Sandoval,0,0,1,4,0,5,5183
17167,G1701670,Sangamon,0,2,7,2,0,11,8235
26151,G2601510,Sanilac,0,0,0,1,0,1,1624
49039,G4900390,Sanpete,1,1,12,7,0,21,2144
06083,G0600830,Santa Barbara,0,4,5,14,0,23,32821
06085,G0600850,Santa Clara,2,4,26,50,0,82,83824
06087,G0600870,Santa Cruz,0,0,0,5,0,5,18654
12113,G1201130,Santa Rosa,0,1,7,6,0,14,6958
12115,G1201150,Sarasota,0,10,17,16,0,43,11383
31153,G3101530,Sarpy,0,0,2,4,0,6,7157
31155,G3101550,Saunders,0,0,0,1,0,1,720
42107,G4201070,Schuylkill,0,2,3,3,0,8,5823
39145,G3901450,Scioto,0,0,3,0,0,3,4127
37165,G3701650,Scotland,0,2,5,3,0,10,1612
19163,G1901630,Scott,0,0,5,1,0,6,7202
21209,G2102090,Scott,0,0,0,1,0,1,2173
27139,G2701390,Scott,0,0,1,2,0,3,4253
28123,G2801230,Scott,0,1,2,1,0,4,1470
51169,G5101690,Scott,1,20,30,16,0,67,872
13251,G1302510,Screven,0,1,0,0,0,1,645
05131,G0501310,Sebastian,0,3,5,6,0,14,6091
20173,G2001730,Sedgwick,2,5,16,5,0,28,23994
12117,G1201170,Seminole,3,6,17,10,0,36,21935
13253,G1302530,Seminole,0,0,1,1,0,2,309
39147,G3901470,Seneca,0,0,0,2,0,2,3221
40135,G4001350,Sequoyah,0,1,1,0,0,2,1746
05133,G0501330,Sevier,0,0,1,0,0,1,814
47155,G4701550,Sevier,0,0,0,1,0,1,3917
28125,G2801250,Sharkey,0,0,1,0,0,1,197
06089,G0600890,Shasta,0,0,0,2,0,2,8202
20177,G2001770,Shawnee,0,0,2,2,0,4,7524
01117,G0101170,Shelby,0,6,13,12,0,31,7531
19165,G1901650,Shelby,0,1,1,0,0,2,371
47157,G4701570,Shelby,1,25,62,50,0,138,46799
48419,G4804190,Shelby,0,1,1,1,0,3,1106
27141,G2701410,Sherburne,0,0,0,1,0,1,4058
31161,G3101610,Sheridan,0,0,0,1,0,1,146
20181,G2001810,Sherman,0,0,0,1,0,1,332
26155,G2601550,Shiawassee,0,0,0,1,0,1,3073
21213,G2102130,Simpson,0,0,1,1,0,2,742
06093,G0600930,Siskiyou,0,0,2,0,0,2,1705
28129,G2801290,Smith,0,2,2,1,0,5,683
48423,G4804230,Smith,1,10,35,23,0,69,11034
53061,G5300610,Snohomish,0,2,17,3,0,22,33011
06095,G0600950,Solano,0,2,8,6,0,16,21290
34035,G3400350,Somerset,0,6,8,1,0,15,11200
06097,G0600970,Sonoma,0,3,12,10,1,26,23991
13255,G1302550,Spalding,0,4,2,3,0,9,2869
45083,G4500830,Spartanburg,1,9,21,8,0,39,13378
53063,G5300630,Spokane,0,4,6,10,0,20,26746
22087,G2200870,St. Bernard,0,0,0,2,0,2,2037
22089,G2200890,St. Charles,0,8,10,3,0,21,2284
29183,G2901830,St. Charles,0,4,5,3,0,12,15897
01115,G0101150,St. Clair,0,1,3,2,0,6,3441
17163,G1701630,St. Clair,0,6,11,6,0,23,12426
26147,G2601470,St. Clair,0,0,0,1,0,1,6694
55109,G5501090,St. Croix,0,1,2,2,0,5,2937
05123,G0501230,St. Francis,0,0,2,0,0,2,1276
29187,G2901870,St. Francois,0,1,1,0,0,2,3537
22091,G2200910,St. Helena,0,0,1,1,0,2,527
22093,G2200930,St. James,1,1,3,7,0,12,1060
22095,G2200950,St. John the Baptist,1,7,8,6,0,22,2222
12109,G1201090,St. Johns,1,3,9,6,0,19,7340
18141,G1801410,St. Joseph,0,2,5,4,0,11,14409
22097,G2200970,St. Landry,0,1,1,5,0,7,3653
36089,G3600890,St. Lawrence,0,0,1,2,0,3,9098
27137,G2701370,St. Louis,0,0,0,1,0,1,13117
29189,G2901890,St. Louis,1,3,20,7,0,31,42851
29510,G2905100,St. Louis,1,9,37,16,0,63,18760
12111,G1201110,St. Lucie,0,5,10,9,0,24,10983
22099,G2200990,St. Martin,1,3,4,2,0,10,2435
22101,G2201010,St. Mary,0,3,8,3,0,14,2673
22103,G2201030,St. Tammany,0,5,6,8,0,19,8607
51179,G5101790,Stafford,0,0,12,1,0,13,6738
06099,G0600990,Stanislaus,0,1,8,5,0,14,27352
37167,G3701670,Stanly,0,1,2,1,0,4,2957
39151,G3901510,Stark,0,11,29,16,0,56,16332
27145,G2701450,Stearns,0,0,0,1,0,1,12046
13257,G1302570,Stephens,0,0,1,1,0,2,1196
40137,G4001370,Stephens,0,1,2,2,0,5,1713
30095,G3000950,Stillwater,0,0,0,1,0,1,261
28131,G2801310,Stone,0,2,7,3,0,12,1144
19169,G1901690,Story,0,0,2,1,0,3,14395
36103,G3601030,Suffolk,0,1,4,7,0,12,68457
51800,G5108000,Suffolk,0,0,2,2,0,4,3347
47163,G4701630,Sullivan,0,1,3,2,0,6,5987
39153,G3901530,Summit,1,7,28,15,0,51,25156
49043,G4900430,Summit,0,0,0,1,0,1,1449
20191,G2001910,Sumner,0,2,3,0,0,5,901
47165,G4701650,Sumner,0,2,1,1,0,4,6291
01119,G0101190,Sumter,0,0,0,2,0,2,969
12119,G1201190,Sumter,0,3,2,2,0,7,2019
13261,G1302610,Sumter,0,2,0,0,0,2,2135
45085,G4500850,Sumter,0,3,4,0,0,7,6041
28133,G2801330,Sunflower,1,0,7,5,0,13,1932
37171,G3701710,Surry,0,0,1,0,0,1,2863
51181,G5101810,Surry,0,0,0,1,0,1,306
10005,G1000050,Sussex,0,0,1,0,0,1,7431
34037,G3400370,Sussex,0,0,1,0,0,1,6072
48435,G4804350,Sutton,0,0,0,1,0,1,147
12121,G1201210,Suwannee,0,1,1,0,0,2,1836
56037,G5600370,Sweetwater,0,0,1,1,0,2,2224
01121,G0101210,Talladega,0,0,1,1,0,2,3437
28135,G2801350,Tallahatchie,0,0,1,0,0,1,1108
01123,G0101230,Tallapoosa,0,2,5,0,0,7,1693
29213,G2902130,Taney,0,0,0,1,0,1,2413
22105,G2201050,Tangipahoa,0,1,2,4,0,7,7315
48439,G4804390,Tarrant,4,35,145,85,0,269,86475
28137,G2801370,Tate,0,2,6,8,0,16,1595
21217,G2102170,Taylor,0,0,0,1,0,1,1425
48441,G4804410,Taylor,0,3,7,3,0,13,9396
51185,G5101850,Tazewell,0,0,2,1,0,3,1788
06103,G0601030,Tehama,0,0,2,2,0,4,2714
22109,G2201090,Terrebonne,0,0,5,0,0,5,5742
40139,G4001390,Texas,0,0,0,1,0,1,1420
13275,G1302750,Thomas,1,1,3,4,0,9,1743
53067,G5300670,Thurston,1,0,2,3,0,6,11455
13277,G1302770,Tift,0,1,1,0,0,2,2385
40141,G4001410,Tillman,0,0,1,0,0,1,351
36107,G3601070,Tioga,0,0,0,1,0,1,1926
28139,G2801390,Tippah,0,0,1,1,0,2,1006
18157,G1801570,Tippecanoe,0,1,0,3,0,4,23637
47167,G4701670,Tipton,0,0,0,3,0,3,2720
48449,G4804490,Titus,0,0,0,1,0,1,1602
48451,G4804510,Tom Green,0,0,0,4,0,4,7913
36109,G3601090,Tompkins,0,0,0,1,0,1,13370
49045,G4900450,Tooele,0,0,0,2,0,2,2251
37175,G3701750,Transylvania,0,0,2,0,0,2,1510
48453,G4804530,Travis,2,12,33,29,0,76,65756
21221,G2102210,Trigg,0,0,1,1,0,2,527
48455,G4804550,Trinity,0,0,0,1,0,1,474
13285,G1302850,Troup,1,8,13,4,0,26,3165
39155,G3901550,Trumbull,2,2,19,10,0,33,8496
06107,G0601070,Tulare,2,5,12,16,0,35,24678
40143,G4001430,Tulsa,2,15,45,27,0,89,29346
28143,G2801430,Tunica,0,0,1,0,0,1,480
01125,G0101250,Tuscaloosa,0,4,9,7,0,20,18879
39157,G3901570,Tuscarawas,0,0,1,1,0,2,3581
26157,G2601570,Tuscola,0,0,0,1,0,1,2337
13289,G1302890,Twiggs,0,2,1,0,0,3,397
48457,G4804570,Tyler,0,0,0,1,0,1,1203
56041,G5600410,Uinta,0,0,0,2,0,2,816
41059,G4100590,Umatilla,0,0,1,3,0,4,3878
05139,G0501390,Union,0,1,0,7,0,8,1667
12125,G1201250,Union,1,0,2,0,0,3,983
13291,G1302910,Union,0,0,1,0,0,1,680
28145,G2801450,Union,0,1,0,0,0,1,1173
34039,G3400390,Union,1,3,5,11,0,20,23598
37179,G3701790,Union,0,2,5,4,0,11,7630
39159,G3901590,Union,0,1,3,1,0,5,1679
45087,G4500870,Union,0,1,5,2,0,8,1090
48459,G4804590,Upshur,1,5,3,3,0,12,1575
13293,G1302930,Upson,0,0,1,1,0,2,1208
49049,G4900490,Utah,0,12,16,12,0,40,39226
48465,G4804650,Val Verde,0,0,1,0,0,1,2847
39161,G3901610,Van Wert,0,0,3,1,0,4,1041
48467,G4804670,Van Zandt,1,0,2,0,0,3,1985
37181,G3701810,Vance,0,0,2,0,0,2,2089
18163,G1801630,Vanderburgh,0,0,3,3,0,6,9930
42121,G4201210,Venango,0,2,0,2,0,4,2040
06111,G0601110,Ventura,4,7,35,25,0,71,43043
22113,G2201130,Vermilion,0,0,1,0,0,1,2472
22115,G2201150,Vernon,0,1,3,0,0,4,3898
48469,G4804690,Victoria,0,0,0,1,0,1,3887
18167,G1801670,Vigo,0,1,1,0,0,2,8101
55125,G5501250,Vilas,0,0,1,0,0,1,623
51810,G5108100,Virginia Beach,3,9,25,9,0,46,24847
12127,G1201270,Volusia,1,12,29,11,0,53,23676
20197,G2001970,Wabaunsee,0,0,0,1,0,1,223
40145,G4001450,Wagoner,0,2,7,5,0,14,2683
37183,G3701830,Wake,2,3,20,6,0,31,44381
12129,G1201290,Wakulla,1,2,3,0,0,6,1345
01127,G0101270,Walker,0,0,4,2,0,6,2726
13295,G1302950,Walker,1,1,3,0,0,5,2711
48471,G4804710,Walker,0,1,2,2,0,5,7066
53071,G5300710,Walla Walla,0,0,0,1,0,1,4099
48473,G4804730,Waller,2,4,10,2,0,18,3679
41063,G4100630,Wallowa,0,0,1,0,0,1,188
28147,G2801470,Walthall,0,0,2,3,0,5,627
13297,G1302970,Walton,2,1,4,3,0,10,3374
55127,G5501270,Walworth,0,0,1,0,0,1,6458
38101,G3801010,Ward,0,0,0,1,0,1,4666
13299,G1302990,Ware,0,0,0,4,0,4,1897
19181,G1901810,Warren,0,0,1,0,0,1,2060
21227,G2102270,Warren,0,0,3,2,0,5,8966
28149,G2801490,Warren,0,1,0,5,0,6,1990
29219,G2902190,Warren,0,0,1,0,0,1,1306
34041,G3400410,Warren,0,0,3,3,0,6,4413
36113,G3601130,Warren,0,0,1,0,0,1,2564
37185,G3701850,Warren,0,0,0,1,0,1,933
39165,G3901650,Warren,0,3,3,7,0,13,7911
42123,G4201230,Warren,0,0,0,1,0,1,1504
47177,G4701770,Warren,0,0,1,0,0,1,1522
18173,G1801730,Warrick,0,0,1,0,0,1,2070
41065,G4100650,Wasco,0,0,1,1,0,2,1038
01129,G0101290,Washington,0,0,2,1,0,3,758
05143,G0501430,Washington,1,6,10,6,0,23,15431
13303,G1303030,Washington,0,1,1,0,0,2,1065
19183,G1901830,Washington,0,0,0,1,0,1,735
22117,G2201170,Washington,0,1,4,1,0,6,1934
24043,G2400430,Washington,0,0,1,0,0,1,6655
27163,G2701630,Washington,0,2,5,1,0,8,8958
28151,G2801510,Washington,0,2,4,1,0,7,2367
29221,G2902210,Washington,0,1,0,0,0,1,1049
39167,G3901670,Washington,0,0,0,1,0,1,2747
41067,G4100670,Washington,2,4,6,6,1,19,21932
42125,G4201250,Washington,0,4,3,4,0,11,9430
48477,G4804770,Washington,1,11,23,11,0,46,1887
49053,G4900530,Washington,0,3,4,7,0,14,6515
55131,G5501310,Washington,0,0,1,2,0,3,4579
32031,G3200310,Washoe,0,2,2,16,0,20,22865
26161,G2601610,Washtenaw,0,3,6,6,0,15,29601
55133,G5501330,Waukesha,0,4,12,9,0,25,13765
55135,G5501350,Waupaca,0,0,0,1,0,1,1867
55137,G5501370,Waushara,0,0,0,1,0,1,874
13305,G1303050,Wayne,0,0,3,1,0,4,1325
26163,G2601630,Wayne,3,26,43,56,0,128,88234
28153,G2801530,Wayne,1,0,3,4,0,8,940
36117,G3601170,Wayne,0,0,0,1,0,1,3750
37191,G3701910,Wayne,0,1,0,1,0,2,6505
39169,G3901690,Wayne,0,0,2,0,0,2,5681
47183,G4701830,Weakley,0,1,0,0,0,1,3086
49057,G4900570,Weber,0,0,0,6,0,6,12283
19187,G1901870,Webster,0,0,1,2,0,3,2509
22119,G2201190,Webster,0,0,0,3,0,3,1794
28155,G2801550,Webster,0,0,2,0,0,2,406
08123,G0801230,Weld,0,1,1,0,0,2,13523
22121,G2201210,West Baton Rouge,0,0,2,1,0,3,1209
22125,G2201250,West Feliciana,0,0,0,1,0,1,492
36119,G3601190,Westchester,0,1,5,3,0,9,39305
42129,G4201290,Westmoreland,1,6,12,4,0,23,14413
26165,G2601650,Wexford,0,0,1,1,0,2,1295
48481,G4804810,Wharton,0,1,4,2,0,7,1876
53073,G5300730,Whatcom,0,1,3,2,0,6,14241
05145,G0501450,White,0,0,0,1,0,1,4867
13311,G1303110,White,0,0,1,0,0,1,1150
13313,G1303130,Whitfield,0,1,5,0,0,6,5144
53075,G5300750,Whitman,0,0,0,1,0,1,8470
48485,G4804850,Wichita,0,6,0,2,0,8,10661
24045,G2400450,Wicomico,0,0,1,1,0,2,6921
48487,G4804870,Wilbarger,0,0,0,1,0,1,662
01131,G0101310,Wilcox,0,0,2,0,0,2,486
13315,G1303150,Wilcox,0,1,2,1,0,4,521
13317,G1303170,Wilkes,0,1,1,2,0,4,415
37193,G3701930,Wilkes,0,1,0,0,0,1,2553
13319,G1303190,Wilkinson,0,0,1,0,0,1,377
28157,G2801570,Wilkinson,0,1,2,1,0,4,556
17197,G1701970,Will,3,11,23,10,0,47,28606
38105,G3801050,Williams,0,0,1,0,0,1,1116
45089,G4500890,Williamsburg,0,0,1,2,0,3,1516
51830,G5108300,Williamsburg,0,0,1,1,0,2,2743
47187,G4701870,Williamson,0,4,9,6,0,19,5558
48491,G4804910,Williamson,0,11,15,20,0,46,15980
37195,G3701950,Wilson,0,1,2,2,0,5,3486
47189,G4701890,Wilson,0,0,2,2,0,4,4288
48493,G4804930,Wilson,0,0,2,0,0,2,1609
51840,G5108400,Winchester,0,0,0,1,0,1,1672
22127,G2201270,Winn,0,2,2,2,0,6,710
17201,G1702010,Winnebago,0,0,2,3,0,5,12604
55139,G5501390,Winnebago,0,1,0,3,0,4,9965
19191,G1901910,Winneshiek,0,0,0,1,0,1,1750
01133,G0101330,Winston,0,0,1,0,0,1,929
28159,G2801590,Winston,0,1,0,1,0,2,806
48497,G4804970,Wise,0,0,2,0,0,2,2574
39173,G3901730,Wood,0,0,2,1,0,3,9880
48499,G4804990,Wood,0,0,1,0,0,1,1618
54107,G5401070,Wood,0,1,2,2,0,5,3223
55141,G5501410,Wood,0,1,1,0,0,2,2901
19193,G1901930,Woodbury,0,1,0,0,0,1,5405
17203,G1702030,Woodford,0,0,1,1,0,2,1636
05147,G0501470,Woodruff,0,0,0,1,0,1,258
24047,G2400470,Worcester,0,1,0,0,0,1,1801
25027,G2500270,Worcester,0,2,1,1,0,4,39549
27171,G2701710,Wright,0,0,0,1,0,1,4279
39175,G3901750,Wyandot,0,0,0,1,0,1,834
20209,G2002090,Wyandotte,0,0,3,0,0,3,7641
37197,G3701970,Yadkin,0,0,1,0,0,1,1450
53077,G5300770,Yakima,0,0,2,2,0,4,12701
28161,G2801610,Yalobusha,0,0,1,1,0,2,508
41071,G4100710,Yamhill,0,0,1,0,0,1,5189
04025,G0400250,Yavapai,0,2,1,1,0,4,8047
28163,G2801630,Yazoo,0,1,0,0,0,1,1290
30111,G3001110,Yellowstone,0,0,1,1,0,2,6525
06113,G0601130,Yolo,0,0,1,3,0,4,18353
31185,G3101850,York,0,0,0,1,0,1,653
42133,G4201330,York,0,3,5,2,0,10,18467
45091,G4500910,York,1,5,7,2,0,15,9652
48503,G4805030,Young,0,0,1,0,0,1,732
06115,G0601150,Yuba,0,0,0,2,0,2,3885
04027,G0400270,Yuma,0,3,14,5,0,22,11512
08125,G0801250,Yuma,0,0,0,1,0,1,404
